11111
10P01
10001
1EE01
1P001
11111