11111
10P01
10001
10001
1P001
11111