11111
10001
10001
1EE01
1P001
11111